A Walk in the Park
An Interactive Fiction by Zeya
Release 1 / Serial number 220114 / Inform 7 build 6M62 (I6/v6.33 lib 6/12N) SD

Courtyard
You wake up in a daze. Where are you? The breeze is warm but there is something off about the air around you. There are beds of poorly maintained flowers. The grass is green, and the foliage is healthy, so there must be something keeping the plants alive. Moss grows over the stone steps that lead north to a small castle- perhaps one may even call it a large watchtower?

>n
Great Hall
What is this place? Your eyes quickly dart around the room to make sense of your surroundings. The stone walls make every movement in the room echo. To the north is a large marble archway, the west a door, and the east another entranceway.

A door which seems to conceal a special room.

You can also see a Jester here.

>e
East Wing
A rectangular room. Mostly a kitchen, consisting of a wood burning stove, sink, and lots of counterspace.

You can see five apples, two poisonous potatoes, Intricate Bronze Key and a Paper Note here.

>s
You can't go that way.

* * *

>e
East Wing
A rectangular room. Mostly a kitchen, consisting of a wood burning stove, sink, and lots of counterspace.

You can see five apples, two poisonous potatoes, Intricate Bronze Key and a Paper Note here.

>take Intricate Bronze Key
Taken.

>w
Great Hall
A long hall with two equally as long tables set on either side of a fire pit. The tables seem to be set as if there were guests to be present tonight. However, the firepit doesn't seem to have been used in ages.

A door which seems to conceal a special room.

>w
(first opening the Bronze Metal Door)
It seems to be locked.

>unlock Bronze Metal Door
(with Intricate Bronze Key)
You unlock the Bronze Metal Door.

>w
(first opening the Bronze Metal Door)

Secret Room
A room the size of a broomcloset. Clean of dust unlike the rest of the castle. Someone must be keeping this space clean.

A door which leads back to the Great Hall .

* * *

>e
East Wing
A rectangular room. Mostly a kitchen, consisting of a wood burning stove, sink, and lots of counterspace.

You can see five apples, two poisonous potatoes, Intricate Bronze Key and a Paper Note here.

>eat apple
(first taking the apple)
Mm, crisp and refreshing. That made me feel better. (Your current health is now 10.)

>l
East Wing
A rectangular room. Mostly a kitchen, consisting of a wood burning stove, sink, and lots of counterspace.

You can see four apples and Intricate Bronze Key here.

* * *

>eat apple
(first taking the apple)
Mm, crisp and refreshing. That made me feel better. (Your current health is now 10.)

>n
You can't go that way.

>w
Great Hall
A long hall with two equally as long tables set on either side of a fire pit. The tables seem to be set as if there were guests to be present tonight. However, the firepit doesn't seem to have been used in ages.

A door which seems to conceal a special room.

* * *

>eat apple
(first taking the apple)
Mm, crisp and refreshing. That made me feel better. (Your current health is now 10.)

>eat apple
(first taking the apple)
BLEGH! The apple was poisoned! Who could have done this... (Your current health is now 9.)

>eat apple
(first taking the apple)
Mm, crisp and refreshing. That made me feel better. (Your current health is now 10.)

>eat apple
(first taking the apple)
Mm, crisp and refreshing. That made me feel better. (Your current health is now 10.)

>eat apple
You can't see any such thing.

* * *

>e
East Wing
A rectangular room. Mostly a kitchen, consisting of a wood burning stove, sink, and lots of counterspace.

You can see five apples, two poisonous potatoes, Intricate Bronze Key and a Paper Note here.

>take intricate bronze key
Taken.

>w
Great Hall
A long hall with two equally as long tables set on either side of a fire pit. The tables seem to be set as if there were guests to be present tonight. However, the firepit doesn't seem to have been used in ages.

A door which seems to conceal a special room.

You can also see a Jester here.

>w
(first opening the Bronze Metal Door)
It seems to be locked.

>unlock bronze metal door
(with Intricate Bronze Key)
You unlock the Bronze Metal Door.

>w
(first opening the Bronze Metal Door)

Secret Room
A room the size of a broomcloset. Clean of dust unlike the rest of the castle. Someone must be keeping this space clean.

A door which leads back to the Great Hall.

You can also see a Scarlett Book and a Blessing of the Gods here.

>examine scarlett book
You see nothing special about the Scarlett Book.

>read scarlett book
You read: THE WAY TO BANISH THE WITCH OF THE HOUSE:

* * *

>w
(first opening the Bronze Metal Door)

Secret Room
A room the size of a broomcloset. Clean of dust unlike the rest of the castle. Someone must be keeping this space clean.

A door which leads back to the Great Hall.

You can also see a Scarlett Book and a Blessing of the Gods here.

>open crystal boz
You can't see any such thing.

>x Scarlett Book
A leatherbound, blood colored book which is surprisingly warm to the touch. What happens when you read the contents?

>read scarlett book
You read: Take the Witch's tea- You must carry the tea with you to prove to her that you know it. Take it, and tell her about it.

>l
Secret Room
A room the size of a broomcloset. Clean of dust unlike the rest of the castle. Someone must be keeping this space clean.

A door which leads back to the Great Hall.

You can also see a Scarlett Book and a Witch's Cup of Tea here.

>x witch's cup of tea
A seemingly sour herbal blend of things. You hear whispers coming from the cup.

>take witch's cup of tea
Taken.

>e
Great Hall
A long hall with two equally as long tables set on either side of a fire pit. The tables seem to be set as if there were guests to be present tonight. However, the firepit doesn't seem to have been used in ages.

A door which seems to conceal a special room.

You can also see a Jester here.

>n
Throne Room
An immense marble room with stained glass windows. A room too large to make sense from the outside. All colors of light cascade around the room. In the very back is a black velvet throne.

You can see a Wicked Witch here.

* * *

>w
(first opening the Bronze Metal Door)

Secret Room
A room the size of a broomcloset. Clean of dust unlike the rest of the castle. Someone must be keeping this space clean.

A door which leads back to the Great Hall.

You can also see a Scarlett Book and a Blessing of the Gods here.

>take blessing of the gods
Taken.

>e
Great Hall
A long hall with two equally as long tables set on either side of a fire pit. The tables seem to be set as if there were guests to be present tonight. However, the firepit doesn't seem to have been used in ages.

A door which seems to conceal a special room.

You can also see a Jester here.

* * *

>n
Throne Room
An immense marble room with stained glass windows. A room too large to make sense from the outside. All colors of light cascade around the room. In the very back is a black velvet throne.

You can see a Wicked Witch here.

>attack wicked witch
*** A sudden strength comes over you. Gold and white lights flood the room. You blink and wake up in your bedroom. ***

Would you like to RESTART, RESTORE a saved game, QUIT or UNDO the last command?

* * *

>e
East Wing
A rectangular room. Mostly a kitchen, consisting of a wood burning stove, sink, and lots of counterspace.

You can see five apples, two poisonous potatoes, Intricate Bronze Key and a Paper Note here.

>examine intricate bronze key
Weighted, and crested with fine jewels.

>look
East Wing
A rectangular room. Mostly a kitchen, consisting of a wood burning stove, sink, and lots of counterspace.

You can see five apples, Intricate Bronze Key and a Note here.

>examine note
The handwriting is barely legible. You do your best and make out the rushed message: "Rid of the witch. Take the key and READ the Scarlett Book in the room to the WEST of the castle. and don't forget to keep an eye on your VITALS."

>vitals
Your current health is 10.

* * *

>e
East Wing
A rectangular room. Mostly a kitchen, consisting of a wood burning stove, sink, and lots of counterspace.

You can see five apples, two poisonous potatoes, Intricate Bronze Key and a Paper Note here.

>take apple
Taken.

>w
Great Hall
A long hall with two equally as long tables set on either side of a fire pit. The tables seem to be set as if there were guests to be present tonight. However, the firepit doesn't seem to have been used in ages.

A door which seems to conceal a special room.

You can also see a Jester here.

>show jester apple
The Jester is unimpressed.

* * *

>e
East Wing
A rectangular room. Mostly a kitchen, consisting of a wood burning stove, sink, and lots of counterspace.

You can see five apples, two poisonous potatoes, Intricate Bronze Key and a Paper Note here.

>take bronze key
Taken.

>w
Great Hall
A long hall with two equally as long tables set on either side of a fire pit. The tables seem to be set as if there were guests to be present tonight. However, the firepit doesn't seem to have been used in ages.

A door which seems to conceal a special room.

You can also see a Jester here.

* * *

>i
You are carrying:
  a Blessing of the Gods
  Intricate Bronze Key

* * *

>e
East Wing
A rectangular room. Mostly a kitchen, consisting of a wood burning stove, sink, and lots of counterspace.

You can see five apples, two poisonous potatoes, Intricate Bronze Key and a Paper Note here.

>eat poisonous potatoes
You can't use multiple objects with that verb.

>eat poisonous potato
(first taking the poisonous potato)
BLEGH! Why would I do that!? (Your current health is now 8.)

>eat poisonous potato
(first taking the poisonous potato)
BLEGH! Why would I do that!? (Your current health is now 6.)

>eat apple
(first taking the apple)
Mm, crisp and refreshing. That made me feel better. (Your current health is now 7.)

* * *

>n
Great Hall
What is this place? Your eyes quickly dart around the room to make sense of your surroundings. The stone walls make every movement in the room echo. To the north is a large marble archway, the west a door, and the east another entranceway.

A door which seems to conceal a special room.

You can also see a Jester here.

>n
Throne Room
An immense marble room with stained glass windows. A room too large to make sense from the outside. All colors of light cascade around the room. In the very back is a black velvet throne.

You can see a Wicked Witch here.

>n
You can't go that way.

>s
Great Hall
A long hall with two equally as long tables set on either side of a fire pit. The tables seem to be set as if there were guests to be present tonight. However, the firepit doesn't seem to have been used in ages.

I beg your pardon?

>e
East Wing
A rectangular room. Mostly a kitchen, consisting of a wood burning stove, sink, and lots of counterspace.

>w
Great Hall
A long hall with two equally as long tables set on either side of a fire pit. The tables seem to be set as if there were guests to be present tonight. However, the firepit doesn't seem to have been used in ages.

>w
Secret Room
A room the size of a broomcloset. Clean of dust unlike the rest of the castle. Someone must be keeping this space clean.

* * *

>n
Throne Room
An immense marble room with stained glass windows. A room too large to make sense from the outside. All colors of light cascade around the room. In the very back is a black velvet throne.

You can see a Wicked Witch here.

>s
Great Hall
A long hall. The stone walls make every movement in the room echo. To the north is a large marble archway, the west a door, and the east another entranceway.

A door which seems to conceal a special room.

You can also see a Jester here.

>e
East Wing
A rectangular room. Mostly a kitchen, consisting of a wood burning stove, sink, and lots of counterspace.

You can see Intricate Bronze Key here.

>s
You can't go that way.

>w
Great Hall
A long hall with two equally as long tables set on either side of a fire pit. The tables seem to be set as if there were guests to be present tonight. However, the firepit doesn't seem to have been used in ages.

A door meant to conceal something. It's shiny with no scratches, marks, or fingerprints. There must be something important behind it.

>w
(first opening the Bronze Metal Door)
It seems to be locked.

>w
(first opening the Bronze Metal Door)
It seems to be locked.

>e
East Wing
A rectangular room. Mostly a kitchen, consisting of a wood burning stove, sink, and lots of counterspace.

You can see Intricate Bronze Key here.

>pickup Intriate Bronze Key
That's not a verb I recognise.

>take Intricate Bronze Key
Taken.

>l
East Wing
A rectangular room. Mostly a kitchen, consisting of a wood burning stove, sink, and lots of counterspace.

>w
Great Hall
A long hall with two equally as long tables set on either side of a fire pit. The tables seem to be set as if there were guests to be present tonight. However, the firepit doesn't seem to have been used in ages.

A door meant to conceal something. It's shiny with no scratches, marks, or fingerprints. There must be something important behind it.

* * *

>unlock Bronze Metal Door
(with Intricate Bronze Key)
You unlock the Bronze Metal Door.

>s
Courtyard
 Overgrown flowers and mossy stone steps. Nothing too outdone.

>n
Great Hall
A long hall with two equally as long tables set on either side of a fire pit. The tables seem to be set as if there were guests to be present tonight. However, the firepit doesn't seem to have been used in ages.

A door meant to conceal something. It's shiny with no scratches, marks, or fingerprints. There must be something important behind it.

>w
(first opening the Bronze Metal Door)

Secret Room
A room the size of a broomcloset. Clean of dust unlike the rest of the castle. Someone must be keeping this space clean.

A door meant to conceal something. It's shiny with no scratches, marks, or fingerprints. There must be something important behind it.

* * *

>s
Great Hall
A long hall. The stone walls make every movement in the room echo. To the north is a large marble archway, the west a door, and the east another entranceway.

A door which seems to conceal a special room.

You can also see a Jester here.

>talk to jester
The juster jumps at the sight of you. Dear me, I haven't seen another living soul here in DECADES. I'm Eugene. The Jester of the house. Welcome to Fort Granite, our humble abode. Here's ehh- the Jester leans inlittle hint, between the two of us: using the command VITALS usually helps people . That's all.

* * *

>n
Throne Room
An immense marble room with stained glass windows. A room too large to make sense from the outside. All colors of light cascade around the room. In the very back is a black velvet throne.

You can see a Wicked Witch here.

>ask the witch what she is doin here
I didn't understand that sentence.

>ask the wicked witch what she is doing here
I didn't understand that sentence.

>ask
(the Wicked Witch for the Wicked Witch)
(the Wicked Witch first taking the Wicked Witch)
The Wicked Witch has better things to do.

>ask the wicked witch who are you
I didn't understand that sentence.

>ask the wicked witch about who are you
The Lord of the castle, obviously.

>ask the wicked witch about dogs
*** The Wicked Witch didn't have the time to converse about things like that with you. She snapped your neck before eating you whole. ***

Would you like to RESTART, RESTORE a saved game, QUIT or UNDO the last command?

* * *

>n
Throne Room
An immense marble room with stained glass windows. A room too large to make sense from the outside. All colors of light cascade around the room. In the very back is a black velvet throne.

You can see a Wicked Witch here.

>ask who are you
You can't see any such thing.

>ask the wicked witch who are you
I didn't understand that sentence.

* * *

>ask the wicked witch about who are you
The Lord of the castle, obviously.

>ask the wicked witch about dogs
I don't care about things like that. She kicks you. (Your current health is now 9.)

>ask the wicked witch about dogs
I don't care about things like that. She kicks you. (Your current health is now 8.)

>ask the wicked witch about dogs
I don't care about things like that. She kicks you. (Your current health is now 7.)

>ask the wicked witch about dogs
I don't care about things like that. She kicks you. (Your current health is now 6.)

>ask the wicked witch about dogs
I don't care about things like that. She kicks you. (Your current health is now 5.)

>ask the wicked witch about dogs
I don't care about things like that. She kicks you. (Your current health is now 4.)

>ask the wicked witch about dogs
I don't care about things like that. She kicks you. (Your current health is now 3.)

>ask the wicked witch about dogs
I don't care about things like that. She kicks you. (Your current health is now 2.)

>ask the wicked witch about dogs
I don't care about things like that. She kicks you. (Your current health is now 1.)

I beg your pardon?

I beg your pardon?

>vitals
Your current health is 1.

>ask the wicked witch about dogs
I don't care about things like that. She kicks you. (Your current health is now 0.)

    *** The Wicked Witch didn't have the time to converse about things like that with you. She snapped your neck before eating you whole. ***

Would you like to RESTART, RESTORE a saved game, QUIT or UNDO the last command?

* * *

>n
Throne Room
An immense marble room with stained glass windows. A room too large to make sense from the outside. All colors of light cascade around the room. In the very back is a black velvet throne.

You can see a Wicked Witch here.

>attack Wicked Witch
Violence isn't the answer to this one.

>tell the wicked witch hi
I didn't understand that sentence.

>tell the wicked witch about dogs
and then..

* * *

>attack the wicked witch
no.

* * *

>n
Great Hall
What is this place? Your eyes quickly dart around the room to make sense of your surroundings. The stone walls make every movement in the room echo. To the north is a large marble archway, the west a door, and the east another entranceway.

A door which seems to conceal a special room.

You can also see a Jester here.

>w
(first opening the Bronze Metal Door)
It seems to be locked.

>unlock bronze metal door
(with the Bronze Metal Door)
(first taking the Bronze Metal Door)
That's fixed in place.

>w
(first opening the Bronze Metal Door)
It seems to be locked.

* * *

>n
Great Hall
What is this place? Your eyes quickly dart around the room to make sense of your surroundings. The stone walls make every movement in the room echo. To the north is a large marble archway, the west a door, and the east another entranceway.

A door which seems to conceal a special room.

You can also see a Jester here.

>ask the jester about what he is doing here
How would I know, I'm only a Jester.

>ask the jester about zeya
My creator?

>tell the Jester hi
I didn't understand that sentence.

>tell
I didn't understand that sentence.

>actions
Actions listing on.

>ask
What do you want to ask the Jester for?

>tell the jester
I didn't understand that sentence.

>tell the jester about dogs
[telling the Jester about "dogs"]
[(1) asking the Jester about "dogs"]
How would I know, I'm only a Jester.
[(1) asking the Jester about "dogs" - succeeded]

[telling the Jester about "dogs" - failed]

>tell the jester about zeya
[telling the Jester about "zeya"]
[(1) asking the Jester about "zeya"]
My creator?[(1) asking the Jester about "zeya" - succeeded]

[telling the Jester about "zeya" - failed]

>ask the jester about zeya
[asking the Jester about "zeya"]
My creator?[asking the Jester about "zeya" - succeeded]

>tell the jester about zeya
[telling the Jester about "zeya"]
[(1) asking the Jester about "zeya"]
My creator?[(1) asking the Jester about "zeya" - succeeded]

[telling the Jester about "zeya" - failed]

>tell the jester hi
I didn't understand that sentence.

>i
[taking inventory]
You are carrying nothing.

[taking inventory - succeeded]

>e
[going east]

East Wing
A rectangular room. Mostly a kitchen, consisting of a wood burning stove, sink, and lots of counterspace.

You can see five apples, Intricate Bronze Key and a Paper Note here.

[going east - succeeded]

>take apple
[taking the apple]
Taken.
[taking the apple - succeeded]

>w
[going west]

Great Hall
A long hall with two equally as long tables set on either side of a fire pit. The tables seem to be set as if there were guests to be present tonight. However, the firepit doesn't seem to have been used in ages.

A door which seems to conceal a special room.

You can also see a Jester here.

[going west - succeeded]

>give jester apple
[giving the apple to the Jester]
The Jester doesn't seem interested.
[giving the apple to the Jester - failed the block giving rule]

* * *

>n
Great Hall
What is this place? Your eyes quickly dart around the room to make sense of your surroundings. The stone walls make every movement in the room echo. To the north is a large marble archway, the west a door, and the east another entranceway.

A door which seems to conceal a special room.

You can also see a Jester here.

>talk to jester
The juster jumps at the sight of you.
Dear me, I haven't seen another living soul here in DECADES. I'm Eugene. The Jester of the house. Welcome to Fort Granite, our humble abode. Here's ehh- the Jester leans in a little hint, between the two of us: using the command VITALS usually helps people. That's all.

>vitals
Your current health is 10.

* * *

>n
Great Hall
What is this place? Your eyes quickly dart around the room to make sense of your surroundings. The stone walls make every movement in the room echo. To the north is a large marble archway, the west a door, and the east another entranceway.

A door which seems to conceal a special room.

You can also see a Jester here.

>speak to jester
I didn't understand that sentence.

>speak
I didn't understand that sentence.

* * *

>n
Great Hall
What is this place? Your eyes quickly dart around the room to make sense of your surroundings. The stone walls make every movement in the room echo. To the north is a large marble archway, the west a door, and the east another entranceway.

A door which seems to conceal a special room.

You can also see a Jester here.

>talk to the Jester
Something

* * *

A Walk in the Park
An Interactive Fiction by Zeya
Release 1 / Serial number 220114 / Inform 7 build 6M62 (I6/v6.33 lib 6/12N) SD

Courtyard
You wake up in a daze. Where are you? The breeze is warm but there is something off about the air around you. There are beds of poorly maintained flowers. The grass is green, and the foliage is healthy, so there must be something keeping the plants alive. Moss grows over the stone steps that lead north to a small castle- perhaps one may even call it a large watchtower?

>check health
Your current health is 
*** Run-time problem P31: Attempt to use a property of the 'nothing' non-object: property current health

0

* * *

A Walk in the Park
An Interactive Fiction by Zeya
Release 1 / Serial number 220114 / Inform 7 build 6M62 (I6/v6.33 lib 6/12N) SD

Courtyard
You wake up in a daze. Where are you? The breeze is warm but there is something off about the air around you. There are beds of poorly maintained flowers. The grass is green, and the foliage is healthy, so there must be something keeping the plants alive. Moss grows over the stone steps that lead north to a small castle- perhaps one may even call it a large watchtower?

>check health player
You can't see any such thing.

* * *

A Walk in the Park
An Interactive Fiction by Zeya
Release 1 / Serial number 220114 / Inform 7 build 6M62 (I6/v6.33 lib 6/12N) SD

Courtyard
You wake up in a daze. Where are you? The breeze is warm but there is something off about the air around you. There are beds of poorly maintained flowers. The grass is green, and the foliage is healthy, so there must be something keeping the plants alive. Moss grows over the stone steps that lead north to a small castle- perhaps one may even call it a large watchtower?

>hp
That's not a verb I recognise.

>HP
That's not a verb I recognise.

>display
(yourself yourself)
(first taking yourself)
You are always self-possessed.

>show
(yourself yourself)
(first taking yourself)
You are always self-possessed.

>HP player
That's not a verb I recognise.

>hp player
That's not a verb I recognise.

>see
That's not a verb I recognise.

>health
That's not a verb I recognise.

* * *

A Walk in the Park
An Interactive Fiction by Zeya
Release 1 / Serial number 220114 / Inform 7 build 6M62 (I6/v6.33 lib 6/12N) SD

Courtyard
You wake up in a daze. Where are you? The breeze is warm but there is something off about the air around you. There are beds of poorly maintained flowers. The grass is green, and the foliage is healthy, so there must be something keeping the plants alive. Moss grows over the stone steps that lead north to a small castle- perhaps one may even call it a large watchtower?

>Health
Your current health is 
*** Run-time problem P31: Attempt to use a property of the 'nothing' non-object: property current health

0.

* * *

A Walk in the Park
An Interactive Fiction by Zeya
Release 1 / Serial number 220114 / Inform 7 build 6M62 (I6/v6.33 lib 6/12N) SD

Courtyard
You wake up in a daze. Where are you? The breeze is warm but there is something off about the air around you. There are beds of poorly maintained flowers. The grass is green, and the foliage is healthy, so there must be something keeping the plants alive. Moss grows over the stone steps that lead north to a small castle- perhaps one may even call it a large watchtower?

>health
You must supply a noun.

>health player
I only understood you as far as wanting to health.

>health dog
I only understood you as far as wanting to health.

* * *

A Walk in the Park
An Interactive Fiction by Zeya
Release 1 / Serial number 220114 / Inform 7 build 6M62 (I6/v6.33 lib 6/12N) SD

Courtyard
You wake up in a daze. Where are you? The breeze is warm but there is something off about the air around you. There are beds of poorly maintained flowers. The grass is green, and the foliage is healthy, so there must be something keeping the plants alive. Moss grows over the stone steps that lead north to a small castle- perhaps one may even call it a large watchtower?

>health player
I only understood you as far as wanting to health.

>display current health
You can't see any such thing.

* * *

A Walk in the Park
An Interactive Fiction by Zeya
Release 1 / Serial number 220114 / Inform 7 build 6M62 (I6/v6.33 lib 6/12N) SD

Courtyard
You wake up in a daze. Where are you? The breeze is warm but there is something off about the air around you. There are beds of poorly maintained flowers. The grass is green, and the foliage is healthy, so there must be something keeping the plants alive. Moss grows over the stone steps that lead north to a small castle- perhaps one may even call it a large watchtower?

>life
Your current health is 10.

* * *

A Walk in the Park
An Interactive Fiction by Zeya
Release 1 / Serial number 220114 / Inform 7 build 6M62 (I6/v6.33 lib 6/12N) SD

Courtyard
You wake up in a daze. Where are you? The breeze is warm but there is something off about the air around you. There are beds of poorly maintained flowers. The grass is green, and the foliage is healthy, so there must be something keeping the plants alive. Moss grows over the stone steps that lead north to a small castle- perhaps one may even call it a large watchtower?

>vitals
Your current health is 10.

>n
Great Hall
A long hall with two equally as long tables set on either side of a fire pit. The tables seem to be set as if there were guests to be present tonight. However, the firepit doesn't seem to have been used in ages.

A door which seems to conceal a special room.

>e
East Wing
A rectangular room. Mostly a kitchen, consisting of a wood burning stove, sink, and lots of counterspace.

You can see five apples and Intricate Bronze Key here.

>eat apple
(first taking the apple)
Mm, crisp and refreshing. That made me feel better.